- B                - 
-   +F             - 
-  ooo     +       - 
-         oo       - 
-         oo       - 
- +   +   oo    + l- 
-oooooooooooooooooo- 
-                  - 
-                  - 
-               ===- 
-           =      - 
-          =-      - 
-M        =--      - 
-==####   ---     d- 
-------===---======- 

