         B           
=   +         +    = 
-  ==    ==  ===   - 
-                 =- 
-                =-- 
-   ooooooooooooo--- 
-=               --- 
--=               -- 
---  + + M        -- 
---=======##=  #  -- 
-------------  -  -- 
-                d-- 
-                =-- 
-l      F        --- 
-==###===========--- 
--------------------