                     
                     
                     
             d     : 
            ::::   . 
:                 :. 
.    +  +        :.. 
.M  :::::::     :... 
.:             :.... 
..:            ..... 
...  F      + #..... 
...::::##::::::..... 
.................... 
.................... 
....................
