- B      oo        - 
-                +F- 
-M              ooo- 
-==   +            - 
---  ====oo        - 
---##----oo        - 
---------o    ooooo- 
----------         - 
-          ooo     - 
-                  - 
-       oooo      d- 
-     ooo===     ==- 
-        ---     --- 
-l  +   #---   + --- 
-========---=====---
