-              o   - 
-              o   - 
-M   +     +   o  d- 
-=  ========oooooo=- 
-                = - 
-               =  - 
-  #    +          - 
-====  ====  ===   - 
-                  - 
-  F+      +       - 
-  oo    ===      l- 
-        ---      =- 
-       =---#    =-- 
- +  +  ----- +  --- 
-------------------- 
--------------------