                     
                     
                     
      M+           * 
     ****          _ 
*                  _ 
_          *****ooo_ 
_               o  _ 
_l              o  _ 
_*      ***     o d_ 
__**            o**_ 
____           **___ 
____   +   +  *_____ 
____________________ 
____________________ 
____________________