_                    
_                    
_                    
_M+                  
_***               * 
_         +        _ 
_     *******      _ 
_                  _ 
_                 d_ 
_      #         **_ 
_********        ___ 
_________  +  +  ___ 
_________********___ 
____________________ 
____________________ 
____________________