-                  - 
-                  - 
-F   +          + l- 
-ooooooooooooooo===- 
-                  - 
-                  - 
-                  - 
-    ===####===    - 
-  ==--------      - 
-  -  o          + - 
-M+-  o          ==- 
-==-d o            - 
----===            - 
-------##   +    ##- 
-------============-
  